NO ./textures/no_texture.png
SO ./textures/so_texture.png
WE ./textures/we_texture.png
EA ./textures/ea_texture.png

F 255, 120, 203
C 0,100,       200



11111111111
10100000111111
11N10010001111
10100111111
11111111111     1111
