NO ./textures/no_texture.png
SO ./textures/so_texture.png
WE ./textures/we_texture.png
EA ./textures/ea_texture.png

C 0,100,200

F 255, 120, 203


111111111111
111100000011
100N00111111
100011101111
111111111111
