
NO ./textures/NO_texture.png

SO ./textures/SO_texture.png

F       2,100,0

       WE             ./textures/WE_texture.png

EA ./textures/EA_texture.png


    C     255    ,    30,   0



  111      11 111      11111111    111
  101      11111      111111111    11
  111     11111111    11111111111
       11111000011    111000101011  1111
    1111101110011      1000001111  110011
       1111111001111   11100001111 11101
111111  1110000011     1111000111    1111
        11111000011111110000101111
        1111100000000000011111101
        111111110000000001111111111
   111      11111111111111111
111111   11  1 1 1 111111111111111
