NO ./path_to_the_north_texture
SO ./path_to_the_south_texture
WE ./path_to_the_west_texture
EA ./path_to_the_east_texture

C 255,0,0
F 220,100,0


111111
100001
10S101
100001
111111
