NO ./textures/no_texture.png
SO ./textures/so_texture.png
WE ./textures/we_texture.png
EA ./textures/ea_texture.png
C 0,100,200
F 255, 120, 203


111111
101001
110001
1N0001
111111
