NO ./path_to_the_north_texture
SO ./path_to_the_south_texture
WE ./path_to_the_west_texture
EA ./path_to_the_east_texture

C 0,100,200
F 255, 120, 203


111111
1100N1
100001
101001
111111
