NO ./textures/no_texture.png
SO ./textures/so_texture.png
WE ./textures/we_texture.png
EA ./textures/ea_texture.png

C 0,100,200
F 255, 120, 203


111111
1100W1
100001
101001
111111
