

NO ./path_to_the_north_texture
       SO ./path_to_the_south_texture

F        2,100,0

       WE             ./path_to_the_west_texture


EA ./path_to_the_east_texture



    C      255    ,    30,   0


    1 1 1 11 11111 111111111    111111

  111     11111111    11111111111  1
       11111000011    111000101011   1111
    111110111000111     10000011   1100111
       1111111001111     1100001111  1101
111111  1110000011     1111000111    1
        11111000011111110000101111
        11111000000000000011111101
        1111111100000W0001111111111
   111      11111111111111111

111111   11  1 1 1 111111111111111
