NO ./path_to_the_north_texture
              SO ./path_to_the_south_texture

F        220,100,0

       WE              ./path_to_the_west_texture


EA ./path_to_the_east_texture



C 225,30,0



            111111         111111111
       11111000001111    111000000011
11 111  1110000010011     1100000001
       11111000000011    111000101011
    111110111000000111     1000000011
       11111110001111     1100000001111
111111  1110000000011     1111000000111
        1100000000001111111000000101111
        1111100000000000000000011111101
        1111110000000W00000001111111111
  1111     1111110000000000011
  1001      11111110000011111
  1111          111111111111
